***********
*     * S* 
*E *  * ***
*  *  *   *
*  *  *   *
*  *  *   *
*  *      *
***********